########################################
#@######...$$$#......$$#.$$$.#$$$.....$#
#.......>####.#$$#.#####.###.#####.###.#
###.#######.$.#$$#.#.....#$#.......#..$#
#$#.#$..#.#.#.####...#.#.#$#.#######.###
#$#.#.#$$$..#$$.#..###.#.#$#..$$$#.#...#
#.#...#####.###.#.##.#.#.#.##$####.###.#
#...#..#$$$.#$#.#$$....#....#$##$$....$#
#$#.#######.#$#.###.####.##.#$#$$#####.#
#$#.#$$$#$#.#.#.$$$.$#$$$$#..#####..$$$#
###.#$#.........######....$##.#$$..#$#.#
#$#.###########.#.#....###$.$.####$#$#.#
#$#.#.#$$..#$$#.#.#..#.$.#.###.$.#####.#
#.....#$$#..$$###.#..#.#.#.....#..$$$#.#
#.#.#.####.##.#....#..$#...#$#$#$###$$.#
#$#.#...#$$$#.#.#$.#.#######$#$#$$$#####
#$#...#.#$$$#...#$.....$$#.$$#######...#
#$#.###.##########.#.#####.###.....###.#
#$#$$$#......$$#$$.#..$$$#.....###.....>
########################################